64,64,64,64,64,64,64,64,64,64,64,64,64,5,5,3,6,6,6,27,28,6,6,6,2,5,5,64,64,64,64,64,64,64,64,64,64,64,64,64,64,64,64,64,64,64,64,64,64,64,64,64,64,5,5,3,6,6,6,27,28,6,6,6,2,5,5,64,64,64,64,64,64,64,64,64,64,64,64,64,64,64,64,64,64,64,64,64,64,64,64,64,64,5,5,3,6,6,6,27,28,6,6,6,2,5,5,64,64,64,64,64,64,64,64,64,64,64,64,64
64,64,64,64,64,64,64,64,64,64,64,64,64,5,5,3,6,6,6,6,6,6,6,6,2,5,5,64,64,64,64,64,64,64,64,64,64,64,64,64,64,64,64,64,64,64,64,64,64,64,64,64,64,5,5,3,6,6,6,6,6,6,6,6,2,5,5,64,64,64,64,64,64,64,64,64,64,64,64,64,64,64,64,64,64,64,64,64,64,64,64,64,64,5,5,3,6,6,6,6,6,6,6,6,2,5,5,64,64,64,64,64,64,64,64,64,64,64,64,64
64,64,64,64,64,64,64,64,64,64,64,64,64,5,5,3,6,6,6,27,28,6,6,6,2,5,5,64,64,64,64,64,64,64,64,64,64,64,64,64,64,64,64,64,64,64,64,64,64,64,64,64,64,5,5,3,6,6,6,27,28,6,6,6,2,5,5,64,64,64,64,64,64,64,64,64,64,64,64,64,64,64,64,64,64,64,64,64,64,64,64,64,64,5,5,3,6,6,6,27,28,6,6,6,2,5,5,64,64,64,64,64,64,64,64,64,64,64,64,64
64,64,64,64,64,64,64,64,64,64,64,64,64,5,5,3,6,6,6,6,6,6,6,6,2,5,5,64,64,64,64,64,64,64,64,64,64,64,64,64,64,64,64,64,64,64,64,64,64,64,64,64,64,5,5,3,6,6,6,6,6,6,6,6,2,5,5,64,64,64,64,64,64,64,64,64,64,64,64,64,64,64,64,64,64,64,64,64,64,64,64,64,64,5,5,3,6,6,6,6,6,6,6,6,2,5,5,64,64,64,64,64,64,64,64,64,64,64,64,64
64,64,64,64,64,64,64,64,64,64,64,64,64,5,5,3,6,6,6,27,28,6,6,6,2,5,5,64,64,64,64,64,64,64,64,64,64,64,64,64,64,64,64,64,64,64,64,64,64,64,64,64,64,5,5,3,6,6,6,27,28,6,6,6,2,5,5,64,64,64,64,64,64,64,64,64,64,64,64,64,64,64,64,64,64,64,64,64,64,64,64,64,64,5,5,3,6,6,6,27,28,6,6,6,2,5,5,64,64,64,64,64,64,64,64,64,64,64,64,64
64,64,64,64,64,64,64,64,64,64,64,64,64,5,5,3,6,6,6,6,6,6,6,6,2,5,5,64,64,64,64,64,64,64,64,64,64,64,64,64,64,64,64,64,64,64,64,64,64,64,64,64,64,5,5,3,6,6,6,6,6,6,6,6,2,5,5,64,64,64,64,64,64,64,64,64,64,64,64,64,64,64,64,64,64,64,64,64,64,64,64,64,64,5,5,3,6,6,6,6,6,6,6,6,2,5,5,64,64,64,64,64,64,64,64,64,64,64,64,64
64,64,64,64,64,64,64,64,64,64,64,64,64,5,5,3,6,6,6,27,28,6,6,6,2,5,5,64,64,64,64,64,64,64,64,64,64,64,64,64,64,64,64,64,64,64,64,64,64,64,64,64,64,5,5,3,6,6,6,27,28,6,6,6,2,5,5,64,64,64,64,64,64,64,64,64,64,64,64,64,64,64,64,64,64,64,64,64,64,64,64,64,64,5,5,3,6,6,6,27,28,6,6,6,2,5,5,64,64,64,64,64,64,64,64,64,64,64,64,64
64,64,64,64,64,64,64,64,64,64,64,64,64,5,5,3,35,35,35,35,35,35,35,35,2,5,5,64,64,64,64,64,64,64,64,64,64,64,64,64,64,64,64,64,64,64,64,64,64,64,64,64,64,5,5,3,35,35,35,35,35,35,35,35,2,5,5,64,64,64,64,64,64,64,64,64,64,64,64,64,64,64,64,64,64,64,64,64,64,64,64,64,64,5,5,3,35,35,35,35,35,35,35,35,2,5,5,64,64,64,64,64,64,64,64,64,64,64,64,64
5,5,5,5,5,5,5,5,5,5,5,5,5,5,5,3,33,34,33,34,33,34,33,34,2,5,5,5,5,5,5,5,5,5,5,5,5,5,5,5,5,5,5,5,5,5,5,5,5,5,5,5,5,5,5,3,33,34,33,34,33,34,33,34,2,5,5,5,5,5,5,5,5,5,5,5,5,5,5,5,5,5,5,5,5,5,5,5,5,5,5,5,5,5,5,3,33,34,33,34,33,34,33,34,2,5,5,5,5,5,5,5,5,5,5,5,5,5,5,5
5,5,5,5,5,5,5,5,5,5,5,5,5,5,5,3,33,34,33,34,33,34,33,34,2,5,5,5,5,5,5,5,5,5,5,5,5,5,5,5,5,5,5,5,5,5,5,5,5,5,5,5,5,5,5,3,33,34,33,34,33,34,33,34,2,5,5,5,5,5,5,5,5,5,5,5,5,5,5,5,5,5,5,5,5,5,5,5,5,5,5,5,5,5,5,3,33,34,33,34,33,34,33,34,2,5,5,5,5,5,5,5,5,5,5,5,5,5,5,5
13,13,13,13,13,13,13,13,13,13,13,13,13,13,13,18,33,34,33,34,33,34,33,34,17,13,13,13,13,13,13,13,13,13,13,13,13,13,13,13,13,13,13,13,13,13,13,13,13,13,13,13,13,13,13,18,33,34,33,34,33,34,33,34,17,13,13,13,13,13,13,13,13,13,13,13,13,13,13,13,13,13,13,13,13,13,13,13,13,13,13,13,13,13,13,18,33,34,33,34,33,34,33,34,17,13,13,13,13,13,13,13,13,13,13,13,13,13,13,13
6,6,6,6,6,6,6,6,6,6,6,6,41,51,51,51,58,43,43,43,43,43,43,57,51,51,51,42,6,6,6,6,6,6,6,6,6,6,6,6,6,6,6,6,6,6,6,6,6,6,6,6,41,51,51,51,58,43,43,43,43,43,43,57,51,51,51,42,6,6,6,6,6,6,6,6,6,6,6,6,6,6,6,6,6,6,6,6,6,6,6,6,41,51,51,51,58,43,43,43,43,43,43,57,51,51,51,42,6,6,6,6,6,6,6,6,6,6,6,6
6,6,6,6,6,6,6,6,6,6,6,6,41,59,59,59,42,6,6,6,6,6,6,41,59,59,59,42,6,6,6,6,6,6,6,6,6,6,6,6,6,6,6,6,6,6,6,6,6,6,6,6,41,59,59,59,42,6,6,6,6,6,6,41,59,59,59,42,6,6,6,6,6,6,6,6,6,6,6,6,6,6,6,6,6,6,6,6,6,6,6,6,41,59,59,59,42,6,6,6,6,6,6,41,59,59,59,42,6,6,6,6,6,6,6,6,6,6,6,6
6,6,6,6,6,6,6,6,6,6,6,6,41,51,51,51,42,6,6,6,6,6,6,41,51,51,51,42,6,6,6,6,6,6,6,6,6,6,6,6,6,6,6,6,6,6,6,6,6,6,6,6,41,51,51,51,42,6,6,6,6,6,6,41,51,51,51,42,6,6,6,6,6,6,6,6,6,6,6,6,6,6,6,6,6,6,6,6,6,6,6,6,41,51,51,51,42,6,6,6,6,6,6,41,51,51,51,42,6,6,6,6,6,6,6,6,6,6,6,6
6,29,6,29,6,29,6,29,6,29,6,29,41,59,59,59,42,6,6,6,6,6,6,41,59,59,59,42,29,6,29,6,29,6,29,6,29,6,29,6,6,29,6,29,6,29,6,29,6,29,6,29,41,59,59,59,42,6,6,6,6,6,6,41,59,59,59,42,29,6,29,6,29,6,29,6,29,6,29,6,6,29,6,29,6,29,6,29,6,29,6,29,41,59,59,59,42,6,6,6,6,6,6,41,59,59,59,42,29,6,29,6,29,6,29,6,29,6,29,6
6,6,6,6,6,6,6,6,6,6,6,6,41,51,51,51,42,6,6,6,6,6,6,41,51,51,51,42,6,6,6,6,6,6,6,6,6,6,6,6,6,6,6,6,6,6,6,6,6,6,6,6,41,51,51,51,42,6,6,6,6,6,6,41,51,51,51,42,6,6,6,6,6,6,6,6,6,6,6,6,6,6,6,6,6,6,6,6,6,6,6,6,41,51,51,51,42,6,6,6,6,6,6,41,51,51,51,42,6,6,6,6,6,6,6,6,6,6,6,6
6,6,6,6,6,6,6,6,6,6,6,6,41,59,59,59,50,35,35,35,35,35,35,49,59,59,59,42,6,6,6,6,6,6,6,6,6,6,6,6,6,6,6,6,6,6,6,6,6,6,6,6,41,59,59,59,50,35,35,35,35,35,35,49,59,59,59,42,6,6,6,6,6,6,6,6,6,6,6,6,6,6,6,6,6,6,6,6,6,6,6,6,41,59,59,59,50,35,35,35,35,35,35,49,59,59,59,42,6,6,6,6,6,6,6,6,6,6,6,6
15,15,15,15,15,15,15,15,15,15,15,15,15,15,15,25,33,34,33,34,33,34,33,34,24,15,15,15,15,15,15,15,15,15,15,15,15,15,15,15,15,15,15,15,15,15,15,15,15,15,15,15,15,15,15,25,33,34,33,34,33,34,33,34,24,15,15,15,15,15,15,15,15,15,15,15,15,15,15,15,15,15,15,15,15,15,15,15,15,15,15,15,15,15,15,25,33,34,33,34,33,34,33,34,24,15,15,15,15,15,15,15,15,15,15,15,15,15,15,15
5,5,5,5,5,5,5,5,5,5,5,5,5,5,5,3,33,34,33,34,33,34,33,34,2,5,5,5,5,5,5,5,5,5,5,5,5,5,5,5,5,5,5,5,5,5,5,5,5,5,5,5,5,5,5,3,33,34,33,34,33,34,33,34,2,5,5,5,5,5,5,5,5,5,5,5,5,5,5,5,5,5,5,5,5,5,5,5,5,5,5,5,5,5,5,3,33,34,33,34,33,34,33,34,2,5,5,5,5,5,5,5,5,5,5,5,5,5,5,5
5,5,5,5,5,5,5,5,5,5,5,5,5,5,5,3,33,34,33,34,33,34,33,34,2,5,5,5,5,5,5,5,5,5,5,5,5,5,5,5,5,5,5,5,5,5,5,5,5,5,5,5,5,5,5,3,33,34,33,34,33,34,33,34,2,5,5,5,5,5,5,5,5,5,5,5,5,5,5,5,5,5,5,5,5,5,5,5,5,5,5,5,5,5,5,3,33,34,33,34,33,34,33,34,2,5,5,5,5,5,5,5,5,5,5,5,5,5,5,5
91,91,91,91,91,91,91,91,91,91,91,91,91,5,5,3,43,43,43,43,43,43,43,43,2,5,5,91,91,91,91,91,91,91,91,91,91,91,91,91,91,91,91,91,91,91,91,91,91,91,91,91,91,5,5,3,43,43,43,43,43,43,43,43,2,5,5,91,91,91,91,91,91,91,91,91,91,91,91,91,91,91,91,91,91,91,91,91,91,91,91,91,91,5,5,3,43,43,43,43,43,43,43,43,2,5,5,91,91,91,91,91,91,91,91,91,91,91,91,91
91,91,91,91,91,91,91,91,91,91,90,91,91,5,5,3,6,6,6,27,28,6,6,6,2,5,5,91,91,91,91,91,91,91,91,91,91,90,91,91,91,91,91,91,91,91,91,91,91,91,90,91,91,5,5,3,6,6,6,27,28,6,6,6,2,5,5,91,91,91,91,91,91,91,91,91,91,90,91,91,91,91,91,91,91,91,91,91,91,91,90,91,91,5,5,3,6,6,6,27,28,6,6,6,2,5,5,91,91,91,91,91,91,91,91,91,91,90,91,91
91,91,91,90,91,90,91,91,91,91,91,91,91,5,5,3,6,6,6,6,6,6,6,6,2,5,5,91,91,90,91,91,91,90,91,91,91,91,91,91,91,91,91,90,91,90,91,91,91,91,91,91,91,5,5,3,6,6,6,6,6,6,6,6,2,5,5,91,91,90,91,91,91,90,91,91,91,91,91,91,91,91,91,90,91,90,91,91,91,91,91,91,91,5,5,3,6,6,6,6,6,6,6,6,2,5,5,91,91,90,91,91,91,90,91,91,91,91,91,91
91,91,91,91,91,91,91,91,90,91,91,91,91,5,5,3,6,6,6,27,28,6,6,6,2,5,5,91,91,91,91,91,91,91,91,91,91,91,91,91,91,91,91,91,91,91,91,91,90,91,91,91,91,5,5,3,6,6,6,27,28,6,6,6,2,5,5,91,91,91,91,91,91,91,91,91,91,91,91,91,91,91,91,91,91,91,91,91,90,91,91,91,91,5,5,3,6,6,6,27,28,6,6,6,2,5,5,91,91,91,91,91,91,91,91,91,91,91,91,91
91,90,91,91,91,91,91,91,91,91,90,91,91,5,5,3,6,6,6,6,6,6,6,6,2,5,5,91,90,91,91,91,90,91,91,91,91,90,91,91,91,90,91,91,91,91,91,91,91,91,90,91,91,5,5,3,6,6,6,6,6,6,6,6,2,5,5,91,90,91,91,91,90,91,91,91,91,90,91,91,91,90,91,91,91,91,91,91,91,91,90,91,91,5,5,3,6,6,6,6,6,6,6,6,2,5,5,91,90,91,91,91,90,91,91,91,91,90,91,91
91,91,91,91,90,91,91,91,91,91,91,91,91,5,5,3,6,6,6,27,28,6,6,6,2,5,5,91,91,91,91,91,91,91,91,90,91,91,91,91,91,91,91,91,90,91,91,91,91,91,91,91,91,5,5,3,6,6,6,27,28,6,6,6,2,5,5,91,91,91,91,91,91,91,91,90,91,91,91,91,91,91,91,91,90,91,91,91,91,91,91,91,91,5,5,3,6,6,6,27,28,6,6,6,2,5,5,91,91,91,91,91,91,91,91,90,91,91,91,91
91,91,91,91,91,91,91,91,91,91,91,91,91,5,5,3,6,6,6,6,6,6,6,6,2,5,5,91,91,91,90,91,91,91,91,91,91,91,91,91,91,91,91,91,91,91,91,91,91,91,91,91,91,5,5,3,6,6,6,6,6,6,6,6,2,5,5,91,91,91,90,91,91,91,91,91,91,91,91,91,91,91,91,91,91,91,91,91,91,91,91,91,91,5,5,3,6,6,6,6,6,6,6,6,2,5,5,91,91,91,90,91,91,91,91,91,91,91,91,91
91,91,90,91,91,91,90,91,90,91,91,91,91,5,5,3,6,6,6,27,28,6,6,6,2,5,5,91,91,91,91,91,91,91,90,91,91,90,91,91,91,91,90,91,91,91,90,91,90,91,91,91,91,5,5,3,6,6,6,27,28,6,6,6,2,5,5,91,91,91,91,91,91,91,90,91,91,90,91,91,91,91,90,91,91,91,90,91,90,91,91,91,91,5,5,3,6,6,6,27,28,6,6,6,2,5,5,91,91,91,91,91,91,91,90,91,91,90,91,91
91,91,91,91,91,91,91,91,91,91,91,91,91,5,5,3,6,6,6,6,6,6,6,6,2,5,5,91,91,91,91,90,91,91,91,91,91,91,91,91,91,91,91,91,91,91,91,91,91,91,91,91,91,5,5,3,6,6,6,6,6,6,6,6,2,5,5,91,91,91,91,90,91,91,91,91,91,91,91,91,91,91,91,91,91,91,91,91,91,91,91,91,91,5,5,3,6,6,6,6,6,6,6,6,2,5,5,91,91,91,91,90,91,91,91,91,91,91,91,91
91,91,91,91,91,91,91,91,91,91,91,91,91,5,5,3,6,6,6,27,28,6,6,6,2,5,5,91,91,91,91,91,91,91,91,91,91,91,91,91,91,91,91,91,91,91,91,91,91,91,91,91,91,5,5,3,6,6,6,27,28,6,6,6,2,5,5,91,91,91,91,91,91,91,91,91,91,91,91,91,91,91,91,91,91,91,91,91,91,91,91,91,91,5,5,3,6,6,6,27,28,6,6,6,2,5,5,91,91,91,91,91,91,91,91,91,91,91,91,91
64,64,64,64,64,64,64,64,64,64,64,64,64,5,5,3,6,6,6,27,28,6,6,6,2,5,5,64,64,64,64,64,64,64,64,64,64,64,64,64,64,64,64,64,64,64,64,64,64,64,64,64,64,5,5,3,6,6,6,27,28,6,6,6,2,5,5,64,64,64,64,64,64,64,64,64,64,64,64,64,64,64,64,64,64,64,64,64,64,64,64,64,64,5,5,3,6,6,6,27,28,6,6,6,2,5,5,64,64,64,64,64,64,64,64,64,64,64,64,64
64,64,64,64,64,64,64,64,64,64,64,64,64,5,5,3,6,6,6,6,6,6,6,6,2,5,5,64,64,64,64,64,64,64,64,64,64,64,64,64,64,64,64,64,64,64,64,64,64,64,64,64,64,5,5,3,6,6,6,6,6,6,6,6,2,5,5,64,64,64,64,64,64,64,64,64,64,64,64,64,64,64,64,64,64,64,64,64,64,64,64,64,64,5,5,3,6,6,6,6,6,6,6,6,2,5,5,64,64,64,64,64,64,64,64,64,64,64,64,64
64,64,64,64,64,64,64,64,64,64,64,64,64,5,5,3,6,6,6,27,28,6,6,6,2,5,5,64,64,64,64,64,64,64,64,64,64,64,64,64,64,64,64,64,64,64,64,64,64,64,64,64,64,5,5,3,6,6,6,27,28,6,6,6,2,5,5,64,64,64,64,64,64,64,64,64,64,64,64,64,64,64,64,64,64,64,64,64,64,64,64,64,64,5,5,3,6,6,6,27,28,6,6,6,2,5,5,64,64,64,64,64,64,64,64,64,64,64,64,64
64,64,64,64,64,64,64,64,64,64,64,64,64,5,5,3,6,6,6,6,6,6,6,6,2,5,5,64,64,64,64,64,64,64,64,64,64,64,64,64,64,64,64,64,64,64,64,64,64,64,64,64,64,5,5,3,6,6,6,6,6,6,6,6,2,5,5,64,64,64,64,64,64,64,64,64,64,64,64,64,64,64,64,64,64,64,64,64,64,64,64,64,64,5,5,3,6,6,6,6,6,6,6,6,2,5,5,64,64,64,64,64,64,64,64,64,64,64,64,64
64,64,64,64,64,64,64,64,64,64,64,64,64,5,5,3,6,6,6,27,28,6,6,6,2,5,5,64,64,64,64,64,64,64,64,64,64,64,64,64,64,64,64,64,64,64,64,64,64,64,64,64,64,5,5,3,6,6,6,27,28,6,6,6,2,5,5,64,64,64,64,64,64,64,64,64,64,64,64,64,64,64,64,64,64,64,64,64,64,64,64,64,64,5,5,3,6,6,6,27,28,6,6,6,2,5,5,64,64,64,64,64,64,64,64,64,64,64,64,64
64,64,64,64,64,64,64,64,64,64,64,64,64,5,5,3,6,6,6,6,6,6,6,6,2,5,5,64,64,64,64,64,64,64,64,64,64,64,64,64,64,64,64,64,64,64,64,64,64,64,64,64,64,5,5,3,6,6,6,6,6,6,6,6,2,5,5,64,64,64,64,64,64,64,64,64,64,64,64,64,64,64,64,64,64,64,64,64,64,64,64,64,64,5,5,3,6,6,6,6,6,6,6,6,2,5,5,64,64,64,64,64,64,64,64,64,64,64,64,64
64,64,64,64,64,64,64,64,64,64,64,64,64,5,5,3,6,6,6,27,28,6,6,6,2,5,5,64,64,64,64,64,64,64,64,64,64,64,64,64,64,64,64,64,64,64,64,64,64,64,64,64,64,5,5,3,6,6,6,27,28,6,6,6,2,5,5,64,64,64,64,64,64,64,64,64,64,64,64,64,64,64,64,64,64,64,64,64,64,64,64,64,64,5,5,3,6,6,6,27,28,6,6,6,2,5,5,64,64,64,64,64,64,64,64,64,64,64,64,64
64,64,64,64,64,64,64,64,64,64,64,64,64,5,5,3,35,35,35,35,35,35,35,35,2,5,5,64,64,64,64,64,64,64,64,64,64,64,64,64,64,64,64,64,64,64,64,64,64,64,64,64,64,5,5,3,35,35,35,35,35,35,35,35,2,5,5,64,64,64,64,64,64,64,64,64,64,64,64,64,64,64,64,64,64,64,64,64,64,64,64,64,64,5,5,3,35,35,35,35,35,35,35,35,2,5,5,64,64,64,64,64,64,64,64,64,64,64,64,64
5,5,5,5,5,5,5,5,5,5,5,5,5,5,5,3,33,34,33,34,33,34,33,34,2,5,5,5,5,5,5,5,5,5,5,5,5,5,5,5,5,5,5,5,5,5,5,5,5,5,5,5,5,5,5,3,33,34,33,34,33,34,33,34,2,5,5,5,5,5,5,5,5,5,5,5,5,5,5,5,5,5,5,5,5,5,5,5,5,5,5,5,5,5,5,3,33,34,33,34,33,34,33,34,2,5,5,5,5,5,5,5,5,5,5,5,5,5,5,5
5,5,5,5,5,5,5,5,5,5,5,5,5,5,5,3,33,34,33,34,33,34,33,34,2,5,5,5,5,5,5,5,5,5,5,5,5,5,5,5,5,5,5,5,5,5,5,5,5,5,5,5,5,5,5,3,33,34,33,34,33,34,33,34,2,5,5,5,5,5,5,5,5,5,5,5,5,5,5,5,5,5,5,5,5,5,5,5,5,5,5,5,5,5,5,3,33,34,33,34,33,34,33,34,2,5,5,5,5,5,5,5,5,5,5,5,5,5,5,5
13,13,13,13,13,13,13,13,13,13,13,13,13,13,13,18,33,34,33,34,33,34,33,34,17,13,13,13,13,13,13,13,13,13,13,13,13,13,13,13,13,13,13,13,13,13,13,13,13,13,13,13,13,13,13,18,33,34,33,34,33,34,33,34,17,13,13,13,13,13,13,13,13,13,13,13,13,13,13,13,13,13,13,13,13,13,13,13,13,13,13,13,13,13,13,18,33,34,33,34,33,34,33,34,17,13,13,13,13,13,13,13,13,13,13,13,13,13,13,13
6,6,6,6,6,6,6,6,6,6,6,6,41,51,51,51,58,43,43,43,43,43,43,57,51,51,51,42,6,6,6,6,6,6,6,6,6,6,6,6,6,6,6,6,6,6,6,6,6,6,6,6,41,51,51,51,58,43,43,43,43,43,43,57,51,51,51,42,6,6,6,6,6,6,6,6,6,6,6,6,6,6,6,6,6,6,6,6,6,6,6,6,41,51,51,51,58,43,43,43,43,43,43,57,51,51,51,42,6,6,6,6,6,6,6,6,6,6,6,6
6,6,6,6,6,6,6,6,6,6,6,6,41,59,59,59,42,6,6,6,6,6,6,41,59,59,59,42,6,6,6,6,6,6,6,6,6,6,6,6,6,6,6,6,6,6,6,6,6,6,6,6,41,59,59,59,42,6,6,6,6,6,6,41,59,59,59,42,6,6,6,6,6,6,6,6,6,6,6,6,6,6,6,6,6,6,6,6,6,6,6,6,41,59,59,59,42,6,6,6,6,6,6,41,59,59,59,42,6,6,6,6,6,6,6,6,6,6,6,6
6,6,6,6,6,6,6,6,6,6,6,6,41,51,51,51,42,6,6,6,6,6,6,41,51,51,51,42,6,6,6,6,6,6,6,6,6,6,6,6,6,6,6,6,6,6,6,6,6,6,6,6,41,51,51,51,42,6,6,6,6,6,6,41,51,51,51,42,6,6,6,6,6,6,6,6,6,6,6,6,6,6,6,6,6,6,6,6,6,6,6,6,41,51,51,51,42,6,6,6,6,6,6,41,51,51,51,42,6,6,6,6,6,6,6,6,6,6,6,6
6,29,6,29,6,29,6,29,6,29,6,29,41,59,59,59,42,6,6,6,6,6,6,41,59,59,59,42,29,6,29,6,29,6,29,6,29,6,29,6,6,29,6,29,6,29,6,29,6,29,6,29,41,59,59,59,42,6,6,6,6,6,6,41,59,59,59,42,29,6,29,6,29,6,29,6,29,6,29,6,6,29,6,29,6,29,6,29,6,29,6,29,41,59,59,59,42,6,6,6,6,6,6,41,59,59,59,42,29,6,29,6,29,6,29,6,29,6,29,6
6,6,6,6,6,6,6,6,6,6,6,6,41,51,51,51,42,6,6,6,6,6,6,41,51,51,51,42,6,6,6,6,6,6,6,6,6,6,6,6,6,6,6,6,6,6,6,6,6,6,6,6,41,51,51,51,42,6,6,6,6,6,6,41,51,51,51,42,6,6,6,6,6,6,6,6,6,6,6,6,6,6,6,6,6,6,6,6,6,6,6,6,41,51,51,51,42,6,6,6,6,6,6,41,51,51,51,42,6,6,6,6,6,6,6,6,6,6,6,6
6,6,6,6,6,6,6,6,6,6,6,6,41,59,59,59,50,35,35,35,35,35,35,49,59,59,59,42,6,6,6,6,6,6,6,6,6,6,6,6,6,6,6,6,6,6,6,6,6,6,6,6,41,59,59,59,50,35,35,35,35,35,35,49,59,59,59,42,6,6,6,6,6,6,6,6,6,6,6,6,6,6,6,6,6,6,6,6,6,6,6,6,41,59,59,59,50,35,35,35,35,35,35,49,59,59,59,42,6,6,6,6,6,6,6,6,6,6,6,6
15,15,15,15,15,15,15,15,15,15,15,15,15,15,15,25,33,34,33,34,33,34,33,34,24,15,15,15,15,15,15,15,15,15,15,15,15,15,15,15,15,15,15,15,15,15,15,15,15,15,15,15,15,15,15,25,33,34,33,34,33,34,33,34,24,15,15,15,15,15,15,15,15,15,15,15,15,15,15,15,15,15,15,15,15,15,15,15,15,15,15,15,15,15,15,25,33,34,33,34,33,34,33,34,24,15,15,15,15,15,15,15,15,15,15,15,15,15,15,15
5,5,5,5,5,5,5,5,5,5,5,5,5,5,5,3,33,34,33,34,33,34,33,34,2,5,5,5,5,5,5,5,5,5,5,5,5,5,5,5,5,5,5,5,5,5,5,5,5,5,5,5,5,5,5,3,33,34,33,34,33,34,33,34,2,5,5,5,5,5,5,5,5,5,5,5,5,5,5,5,5,5,5,5,5,5,5,5,5,5,5,5,5,5,5,3,33,34,33,34,33,34,33,34,2,5,5,5,5,5,5,5,5,5,5,5,5,5,5,5
5,5,5,5,5,5,5,5,5,5,5,5,5,5,5,3,33,34,33,34,33,34,33,34,2,5,5,5,5,5,5,5,5,5,5,5,5,5,5,5,5,5,5,5,5,5,5,5,5,5,5,5,5,5,5,3,33,34,33,34,33,34,33,34,2,5,5,5,5,5,5,5,5,5,5,5,5,5,5,5,5,5,5,5,5,5,5,5,5,5,5,5,5,5,5,3,33,34,33,34,33,34,33,34,2,5,5,5,5,5,5,5,5,5,5,5,5,5,5,5
91,91,91,91,91,91,91,91,91,91,91,91,91,5,5,3,43,43,43,43,43,43,43,43,2,5,5,91,91,91,91,91,91,91,91,91,91,91,91,91,91,91,91,91,91,91,91,91,91,91,91,91,91,5,5,3,43,43,43,43,43,43,43,43,2,5,5,91,91,91,91,91,91,91,91,91,91,91,91,91,91,91,91,91,91,91,91,91,91,91,91,91,91,5,5,3,43,43,43,43,43,43,43,43,2,5,5,91,91,91,91,91,91,91,91,91,91,91,91,91
91,91,91,91,91,91,91,91,91,91,90,91,91,5,5,3,6,6,6,27,28,6,6,6,2,5,5,91,91,91,91,91,91,91,91,91,91,90,91,91,91,91,91,91,91,91,91,91,91,91,90,91,91,5,5,3,6,6,6,27,28,6,6,6,2,5,5,91,91,91,91,91,91,91,91,91,91,90,91,91,91,91,91,91,91,91,91,91,91,91,90,91,91,5,5,3,6,6,6,27,28,6,6,6,2,5,5,91,91,91,91,91,91,91,91,91,91,90,91,91
91,91,91,90,91,90,91,91,91,91,91,91,91,5,5,3,6,6,6,6,6,6,6,6,2,5,5,91,91,90,91,91,91,90,91,91,91,91,91,91,91,91,91,90,91,90,91,91,91,91,91,91,91,5,5,3,6,6,6,6,6,6,6,6,2,5,5,91,91,90,91,91,91,90,91,91,91,91,91,91,91,91,91,90,91,90,91,91,91,91,91,91,91,5,5,3,6,6,6,6,6,6,6,6,2,5,5,91,91,90,91,91,91,90,91,91,91,91,91,91
91,91,91,91,91,91,91,91,90,91,91,91,91,5,5,3,6,6,6,27,28,6,6,6,2,5,5,91,91,91,91,91,91,91,91,91,91,91,91,91,91,91,91,91,91,91,91,91,90,91,91,91,91,5,5,3,6,6,6,27,28,6,6,6,2,5,5,91,91,91,91,91,91,91,91,91,91,91,91,91,91,91,91,91,91,91,91,91,90,91,91,91,91,5,5,3,6,6,6,27,28,6,6,6,2,5,5,91,91,91,91,91,91,91,91,91,91,91,91,91
91,90,91,91,91,91,91,91,91,91,90,91,91,5,5,3,6,6,6,6,6,6,6,6,2,5,5,91,90,91,91,91,90,91,91,91,91,90,91,91,91,90,91,91,91,91,91,91,91,91,90,91,91,5,5,3,6,6,6,6,6,6,6,6,2,5,5,91,90,91,91,91,90,91,91,91,91,90,91,91,91,90,91,91,91,91,91,91,91,91,90,91,91,5,5,3,6,6,6,6,6,6,6,6,2,5,5,91,90,91,91,91,90,91,91,91,91,90,91,91
91,91,91,91,90,91,91,91,91,91,91,91,91,5,5,3,6,6,6,27,28,6,6,6,2,5,5,91,91,91,91,91,91,91,91,90,91,91,91,91,91,91,91,91,90,91,91,91,91,91,91,91,91,5,5,3,6,6,6,27,28,6,6,6,2,5,5,91,91,91,91,91,91,91,91,90,91,91,91,91,91,91,91,91,90,91,91,91,91,91,91,91,91,5,5,3,6,6,6,27,28,6,6,6,2,5,5,91,91,91,91,91,91,91,91,90,91,91,91,91
91,91,91,91,91,91,91,91,91,91,91,91,91,5,5,3,6,6,6,6,6,6,6,6,2,5,5,91,91,91,90,91,91,91,91,91,91,91,91,91,91,91,91,91,91,91,91,91,91,91,91,91,91,5,5,3,6,6,6,6,6,6,6,6,2,5,5,91,91,91,90,91,91,91,91,91,91,91,91,91,91,91,91,91,91,91,91,91,91,91,91,91,91,5,5,3,6,6,6,6,6,6,6,6,2,5,5,91,91,91,90,91,91,91,91,91,91,91,91,91
91,91,90,91,91,91,90,91,90,91,91,91,91,5,5,3,6,6,6,27,28,6,6,6,2,5,5,91,91,91,91,91,91,91,90,91,91,90,91,91,91,91,90,91,91,91,90,91,90,91,91,91,91,5,5,3,6,6,6,27,28,6,6,6,2,5,5,91,91,91,91,91,91,91,90,91,91,90,91,91,91,91,90,91,91,91,90,91,90,91,91,91,91,5,5,3,6,6,6,27,28,6,6,6,2,5,5,91,91,91,91,91,91,91,90,91,91,90,91,91
91,91,91,91,91,91,91,91,91,91,91,91,91,5,5,3,6,6,6,6,6,6,6,6,2,5,5,91,91,91,91,90,91,91,91,91,91,91,91,91,91,91,91,91,91,91,91,91,91,91,91,91,91,5,5,3,6,6,6,6,6,6,6,6,2,5,5,91,91,91,91,90,91,91,91,91,91,91,91,91,91,91,91,91,91,91,91,91,91,91,91,91,91,5,5,3,6,6,6,6,6,6,6,6,2,5,5,91,91,91,91,90,91,91,91,91,91,91,91,91
91,91,91,91,91,91,91,91,91,91,91,91,91,5,5,3,6,6,6,27,28,6,6,6,2,5,5,91,91,91,91,91,91,91,91,91,91,91,91,91,91,91,91,91,91,91,91,91,91,91,91,91,91,5,5,3,6,6,6,27,28,6,6,6,2,5,5,91,91,91,91,91,91,91,91,91,91,91,91,91,91,91,91,91,91,91,91,91,91,91,91,91,91,5,5,3,6,6,6,27,28,6,6,6,2,5,5,91,91,91,91,91,91,91,91,91,91,91,91,91
64,64,64,64,64,64,64,64,64,64,64,64,64,5,5,3,6,6,6,27,28,6,6,6,2,5,5,64,64,64,64,64,64,64,64,64,64,64,64,64,65,65,65,65,66,67,65,65,65,66,67,65,65,5,5,3,6,6,6,27,28,6,6,6,2,5,5,65,65,66,67,65,65,66,67,65,65,66,67,65,64,64,64,64,64,64,64,64,64,64,64,64,64,5,5,3,6,6,6,27,28,6,6,6,2,5,5,64,64,64,64,64,64,64,64,64,64,64,64,64
64,64,64,64,64,64,64,64,64,64,64,64,64,5,5,3,6,6,6,6,6,6,6,6,2,5,5,64,64,64,64,64,64,64,64,64,64,64,64,64,65,65,65,65,74,75,65,65,65,74,75,65,65,78,78,78,71,71,71,71,71,71,71,71,78,78,78,65,65,74,75,65,65,74,75,65,65,74,75,65,64,64,64,64,64,64,64,64,64,64,64,64,64,5,5,3,6,6,6,6,6,6,6,6,2,5,5,64,64,64,64,64,64,64,64,64,64,64,64,64
64,64,64,64,64,64,64,64,64,64,64,64,64,5,5,3,6,6,6,27,28,6,6,6,2,5,5,64,64,64,64,64,64,64,64,64,64,64,64,64,65,65,65,65,82,83,65,65,65,82,83,65,65,79,79,86,79,79,86,79,79,86,79,79,86,79,79,65,65,82,83,65,65,82,83,65,65,82,83,65,64,64,64,64,64,64,64,64,64,64,64,64,64,5,5,3,6,6,6,27,28,6,6,6,2,5,5,64,64,64,64,64,64,64,64,64,64,64,64,64
64,64,64,64,64,64,64,64,64,64,64,64,64,5,5,3,6,6,6,6,6,6,6,6,2,5,5,64,64,64,64,64,64,64,64,64,64,64,64,64,65,65,65,65,65,65,65,65,65,65,65,65,65,87,87,94,87,87,94,87,87,94,87,87,94,87,87,65,65,65,65,65,65,65,65,65,65,65,65,65,64,64,64,64,64,64,64,64,64,64,64,64,64,5,5,3,6,6,6,6,6,6,6,6,2,5,5,64,64,64,64,64,64,64,64,64,64,64,64,64
64,64,64,64,64,64,64,64,64,64,64,64,64,5,5,3,6,6,6,27,28,6,6,6,2,5,5,64,64,64,64,64,64,64,64,64,64,64,64,64,65,65,66,67,65,65,66,67,36,37,38,39,65,5,5,3,6,6,6,27,28,6,6,6,2,5,5,65,65,66,67,65,36,37,38,39,65,66,67,65,64,64,64,64,64,64,64,64,64,64,64,64,64,5,5,3,6,6,6,27,28,6,6,6,2,5,5,64,64,64,64,64,64,64,64,64,64,64,64,64
64,64,64,64,64,64,64,64,64,64,64,64,64,5,5,3,6,6,6,6,6,6,6,6,2,5,5,64,64,64,64,64,64,64,64,64,64,64,64,64,65,65,74,75,65,65,74,75,44,45,46,47,65,5,5,3,6,6,6,6,6,6,6,6,2,5,5,65,65,74,75,65,44,45,46,47,65,74,75,65,64,64,64,64,64,64,64,64,64,64,64,64,64,5,5,3,6,6,6,6,6,6,6,6,2,5,5,64,64,64,64,64,64,64,64,64,64,64,64,64
64,64,64,64,64,64,64,64,64,64,64,64,64,5,5,3,6,6,6,27,28,6,6,6,2,5,5,64,64,64,64,64,64,64,64,64,64,64,64,64,65,65,82,83,65,65,82,83,52,53,54,55,65,5,5,3,6,6,6,27,28,6,6,6,2,5,5,65,65,82,83,65,52,53,54,55,65,82,83,65,64,64,64,64,64,64,64,64,64,64,64,64,64,5,5,3,6,6,6,27,28,6,6,6,2,5,5,64,64,64,64,64,64,64,64,64,64,64,64,64
64,64,64,64,64,64,64,64,64,64,64,64,64,5,5,3,35,35,35,35,35,35,35,35,2,5,5,64,64,64,64,64,64,64,64,64,64,64,64,64,65,65,65,65,65,65,65,65,60,61,62,63,65,5,5,3,35,35,35,35,35,35,35,35,2,5,5,65,65,65,65,65,60,61,62,63,65,65,65,65,64,64,64,64,64,64,64,64,64,64,64,64,64,5,5,3,35,35,35,35,35,35,35,35,2,5,5,64,64,64,64,64,64,64,64,64,64,64,64,64
5,5,5,5,5,5,5,5,5,5,5,5,5,5,5,3,33,34,33,34,33,34,33,34,2,5,5,5,5,5,5,5,5,5,5,5,5,5,5,5,5,5,5,5,5,5,5,5,5,5,5,5,5,5,5,3,33,34,33,34,33,34,33,34,2,5,5,5,5,5,5,5,5,5,5,5,5,5,5,5,5,5,5,5,5,5,5,5,5,5,5,5,5,5,5,3,33,34,33,34,33,34,33,34,2,5,5,5,5,5,5,5,5,5,5,5,5,5,5,5
5,5,5,5,5,5,5,5,5,5,5,5,5,5,5,3,33,34,33,34,33,34,33,34,2,5,5,5,5,5,5,5,5,5,5,5,5,5,5,5,5,5,5,5,5,5,5,5,5,5,5,5,5,5,5,3,33,34,33,34,33,34,33,34,2,5,5,5,5,5,5,5,5,5,5,5,5,5,5,5,5,5,5,5,5,5,5,5,5,5,5,5,5,5,5,3,33,34,33,34,33,34,33,34,2,5,5,5,5,5,5,5,5,5,5,5,5,5,5,5
13,13,13,13,13,13,13,13,13,13,13,13,13,13,13,18,33,34,33,34,33,34,33,34,17,13,13,13,13,13,13,13,13,13,13,13,13,13,13,13,13,13,13,13,13,13,13,13,13,13,13,13,13,13,13,18,33,34,33,34,33,34,33,34,17,13,13,13,13,13,13,13,13,13,13,13,13,13,13,13,13,13,13,13,13,13,13,13,13,13,13,13,13,13,13,18,33,34,33,34,33,34,33,34,17,13,13,13,13,13,13,13,13,13,13,13,13,13,13,13
6,6,6,6,6,6,6,6,6,6,6,6,41,51,51,51,58,43,43,43,43,43,43,57,51,51,51,42,6,6,6,6,6,6,6,6,6,6,6,6,6,6,6,6,6,6,6,6,6,6,6,6,41,51,51,51,58,43,43,43,43,43,43,57,51,51,51,42,6,6,6,6,6,6,6,6,6,6,6,6,6,6,6,6,6,6,6,6,6,6,6,6,41,51,51,51,58,43,43,43,43,43,43,57,51,51,51,42,6,6,6,6,6,6,6,6,6,6,6,6
6,6,6,6,6,6,6,6,6,6,6,6,41,59,59,59,42,6,6,6,6,6,6,41,59,59,59,42,6,6,6,6,6,6,6,6,6,6,6,6,6,6,6,6,6,6,6,6,6,6,6,6,41,59,59,59,42,6,6,6,6,6,6,41,59,59,59,42,6,6,6,6,6,6,6,6,6,6,6,6,6,6,6,6,6,6,6,6,6,6,6,6,41,59,59,59,42,6,6,6,6,6,6,41,59,59,59,42,6,6,6,6,6,6,6,6,6,6,6,6
6,6,6,6,6,6,6,6,6,6,6,6,41,51,51,51,42,6,6,6,6,6,6,41,51,51,51,42,6,6,6,6,6,6,6,6,6,6,6,6,6,6,6,6,6,6,6,6,6,6,6,6,41,51,51,51,42,6,6,6,6,6,6,41,51,51,51,42,6,6,6,6,6,6,6,6,6,6,6,6,6,6,6,6,6,6,6,6,6,6,6,6,41,51,51,51,42,6,6,6,6,6,6,41,51,51,51,42,6,6,6,6,6,6,6,6,6,6,6,6
6,29,6,29,6,29,6,29,6,29,6,29,41,59,59,59,42,6,6,6,6,6,6,41,59,59,59,42,29,6,29,6,29,6,29,6,29,6,29,6,6,29,6,29,6,29,6,29,6,29,6,29,41,59,59,59,42,6,6,6,6,6,6,41,59,59,59,42,29,6,29,6,29,6,29,6,29,6,29,6,6,29,6,29,6,29,6,29,6,29,6,29,41,59,59,59,42,6,6,6,6,6,6,41,59,59,59,42,29,6,29,6,29,6,29,6,29,6,29,6
6,6,6,6,6,6,6,6,6,6,6,6,41,51,51,51,42,6,6,6,6,6,6,41,51,51,51,42,6,6,6,6,6,6,6,6,6,6,6,6,6,6,6,6,6,6,6,6,6,6,6,6,41,51,51,51,42,6,6,6,6,6,6,41,51,51,51,42,6,6,6,6,6,6,6,6,6,6,6,6,6,6,6,6,6,6,6,6,6,6,6,6,41,51,51,51,42,6,6,6,6,6,6,41,51,51,51,42,6,6,6,6,6,6,6,6,6,6,6,6
6,6,6,6,6,6,6,6,6,6,6,6,41,59,59,59,50,35,35,35,35,35,35,49,59,59,59,42,6,6,6,6,6,6,6,6,6,6,6,6,6,6,6,6,6,6,6,6,6,6,6,6,41,59,59,59,50,35,35,35,35,35,35,49,59,59,59,42,6,6,6,6,6,6,6,6,6,6,6,6,6,6,6,6,6,6,6,6,6,6,6,6,41,59,59,59,50,35,35,35,35,35,35,49,59,59,59,42,6,6,6,6,6,6,6,6,6,6,6,6
15,15,15,15,15,15,15,15,15,15,15,15,15,15,15,25,33,34,33,34,33,34,33,34,24,15,15,15,15,15,15,15,15,15,15,15,15,15,15,15,15,15,15,15,15,15,15,15,15,15,15,15,15,15,15,25,33,34,33,34,33,34,33,34,24,15,15,15,15,15,15,15,15,15,15,15,15,15,15,15,15,15,15,15,15,15,15,15,15,15,15,15,15,15,15,25,33,34,33,34,33,34,33,34,24,15,15,15,15,15,15,15,15,15,15,15,15,15,15,15
5,5,5,5,5,5,5,5,5,5,5,5,5,5,5,3,33,34,33,34,33,34,33,34,2,5,5,5,5,5,5,5,5,5,5,5,5,5,5,5,5,5,5,5,5,5,5,5,5,5,5,5,5,5,5,3,33,34,33,34,33,34,33,34,2,5,5,5,5,5,5,5,5,5,5,5,5,5,5,5,5,5,5,5,5,5,5,5,5,5,5,5,5,5,5,3,33,34,33,34,33,34,33,34,2,5,5,5,5,5,5,5,5,5,5,5,5,5,5,5
5,5,5,5,5,5,5,5,5,5,5,5,5,5,5,3,33,34,33,34,33,34,33,34,2,5,5,5,5,5,5,5,5,5,5,5,5,5,5,5,5,5,5,5,5,5,5,5,5,5,5,5,5,5,5,3,33,34,33,34,33,34,33,34,2,5,5,5,5,5,5,5,5,5,5,5,5,5,5,5,5,5,5,5,5,5,5,5,5,5,5,5,5,5,5,3,33,34,33,34,33,34,33,34,2,5,5,5,5,5,5,5,5,5,5,5,5,5,5,5
91,91,91,91,91,91,91,91,91,91,91,91,91,5,5,3,43,43,43,43,43,43,43,43,2,5,5,91,91,91,91,91,91,91,91,91,91,91,91,91,91,91,91,91,91,91,91,91,91,91,91,91,91,5,5,3,43,43,43,43,43,43,43,43,2,5,5,91,91,91,91,91,91,91,91,91,91,91,91,91,91,91,91,91,91,91,91,91,91,91,91,91,91,5,5,3,43,43,43,43,43,43,43,43,2,5,5,91,91,91,91,91,91,91,91,91,91,91,91,91
91,91,91,91,91,91,91,91,91,91,90,91,91,5,5,3,6,6,6,27,28,6,6,6,2,5,5,91,91,91,91,91,91,91,91,91,91,90,91,91,91,91,91,91,91,91,91,91,91,91,90,91,91,5,5,3,6,6,6,27,28,6,6,6,2,5,5,91,91,91,91,91,91,91,91,91,91,90,91,91,91,91,91,91,91,91,91,91,91,91,90,91,91,5,5,3,6,6,6,27,28,6,6,6,2,5,5,91,91,91,91,91,91,91,91,91,91,90,91,91
91,91,91,90,91,90,91,91,91,91,91,91,91,5,5,3,6,6,6,6,6,6,6,6,2,5,5,91,91,90,91,91,91,90,91,91,91,91,91,91,91,91,91,90,91,90,91,91,91,91,91,91,91,5,5,3,6,6,6,6,6,6,6,6,2,5,5,91,91,90,91,91,91,90,91,91,91,91,91,91,91,91,91,90,91,90,91,91,91,91,91,91,91,5,5,3,6,6,6,6,6,6,6,6,2,5,5,91,91,90,91,91,91,90,91,91,91,91,91,91
91,91,91,91,91,91,91,91,90,91,91,91,91,5,5,3,6,6,6,27,28,6,6,6,2,5,5,91,91,91,91,91,91,91,91,91,91,91,91,91,91,91,91,91,91,91,91,91,90,91,91,91,91,5,5,3,6,6,6,27,28,6,6,6,2,5,5,91,91,91,91,91,91,91,91,91,91,91,91,91,91,91,91,91,91,91,91,91,90,91,91,91,91,5,5,3,6,6,6,27,28,6,6,6,2,5,5,91,91,91,91,91,91,91,91,91,91,91,91,91
91,90,91,91,91,91,91,91,91,91,90,91,91,5,5,3,6,6,6,6,6,6,6,6,2,5,5,91,90,91,91,91,90,91,91,91,91,90,91,91,91,90,91,91,91,91,91,91,91,91,90,91,91,5,5,3,6,6,6,6,6,6,6,6,2,5,5,91,90,91,91,91,90,91,91,91,91,90,91,91,91,90,91,91,91,91,91,91,91,91,90,91,91,5,5,3,6,6,6,6,6,6,6,6,2,5,5,91,90,91,91,91,90,91,91,91,91,90,91,91
91,91,91,91,90,91,91,91,91,91,91,91,91,5,5,3,6,6,6,27,28,6,6,6,2,5,5,91,91,91,91,91,91,91,91,90,91,91,91,91,91,91,91,91,90,91,91,91,91,91,91,91,91,5,5,3,6,6,6,27,28,6,6,6,2,5,5,91,91,91,91,91,91,91,91,90,91,91,91,91,91,91,91,91,90,91,91,91,91,91,91,91,91,5,5,3,6,6,6,27,28,6,6,6,2,5,5,91,91,91,91,91,91,91,91,90,91,91,91,91
91,91,91,91,91,91,91,91,91,91,91,91,91,5,5,3,6,6,6,6,6,6,6,6,2,5,5,91,91,91,90,91,91,91,91,91,91,91,91,91,91,91,91,91,91,91,91,91,91,91,91,91,91,5,5,3,6,6,6,6,6,6,6,6,2,5,5,91,91,91,90,91,91,91,91,91,91,91,91,91,91,91,91,91,91,91,91,91,91,91,91,91,91,5,5,3,6,6,6,6,6,6,6,6,2,5,5,91,91,91,90,91,91,91,91,91,91,91,91,91
91,91,90,91,91,91,90,91,90,91,91,91,91,5,5,3,6,6,6,27,28,6,6,6,2,5,5,91,91,91,91,91,91,91,90,91,91,90,91,91,91,91,90,91,91,91,90,91,90,91,91,91,91,5,5,3,6,6,6,27,28,6,6,6,2,5,5,91,91,91,91,91,91,91,90,91,91,90,91,91,91,91,90,91,91,91,90,91,90,91,91,91,91,5,5,3,6,6,6,27,28,6,6,6,2,5,5,91,91,91,91,91,91,91,90,91,91,90,91,91
91,91,91,91,91,91,91,91,91,91,91,91,91,5,5,3,6,6,6,6,6,6,6,6,2,5,5,91,91,91,91,90,91,91,91,91,91,91,91,91,91,91,91,91,91,91,91,91,91,91,91,91,91,5,5,3,6,6,6,6,6,6,6,6,2,5,5,91,91,91,91,90,91,91,91,91,91,91,91,91,91,91,91,91,91,91,91,91,91,91,91,91,91,5,5,3,6,6,6,6,6,6,6,6,2,5,5,91,91,91,91,90,91,91,91,91,91,91,91,91
91,91,91,91,91,91,91,91,91,91,91,91,91,5,5,3,6,6,6,27,28,6,6,6,2,5,5,91,91,91,91,91,91,91,91,91,91,91,91,91,91,91,91,91,91,91,91,91,91,91,91,91,91,5,5,3,6,6,6,27,28,6,6,6,2,5,5,91,91,91,91,91,91,91,91,91,91,91,91,91,91,91,91,91,91,91,91,91,91,91,91,91,91,5,5,3,6,6,6,27,28,6,6,6,2,5,5,91,91,91,91,91,91,91,91,91,91,91,91,91
